6 6 6 6 6 6 7 7 7 7 7 7 7 7 7 7
6 0 0 0 6 6 2 2 7 7 7 7 7 7 8 7
6 0 0 0 0 0 0 2 2 7 7 8 7 7 7 7
6 0 0 0 0 0 0 2 7 7 7 7 7 7 7 8
6 0 0 0 0 6 0 2 2 2 7 7 8 7 7 7
1 1 1 1 1 0 0 2 2 7 7 7 7 7 7 7
6 0 0 0 1 6 0 2 7 7 7 7 7 7 7 7
6 0 0 0 1 0 0 2 7 7 7 7 7 8 7 7
6 0 0 0 1 1 1 10 10 10 7 7 7 7 8 7
6 0 6 0 0 0 0 10 10 10 7 7 7 7 7 7
6 0 0 0 0 0 6 10 10 10 7 7 8 7 7 7
5 5 5 5 5 5 5 5 10 5 5 5 5 5 5 5