12 12 12 12 12 12 12 12 12 12 12 12 12 12 12 12
12 12 12 12 12 12 12 12 12 12 12 12 12 12 12 12
12 12 12 12 12 12 12 12 12 12 12 12 12 12 12 12
5 5 5 5 5 5 5 5 5 12 12 12 12 12 12 12
5 10 10 10 10 10 10 10 5 12 12 12 12 12 12 12
10 10 10 10 10 10 10 10 5 12 12 12 12 12 12 12 12
5 10 10 10 10 10 10 10 5 12 12 12 12 12 12 12 12
5 5 5 5 5 5 5 5 5 12 12 12 12 12 12 12
12 12 12 12 12 12 12 12 12 12 12 12 12 12 12 12
12 12 12 12 12 12 12 12 12 12 12 12 12 12 12 12
12 12 12 12 12 12 12 12 12 12 12 12 12 12 12 12
12 12 12 12 12 12 12 12 12 12 12 12 12 12 12 12