12 12 12 12 13 13 13 16 13 13 13 12 12 12 12 12 
12 12 12 12 13 13 16 16 16 13 13 12 12 12 12 12
13 19 19 19 19 14 17 17 17 14 19 19 19 19 19 13
13 16 16 16 16 20 18 18 18 20 16 16 16 16 16 13
13 16 16 16 16 16 16 16 16 16 16 16 16 16 16 13
13 16 16 16 16 16 16 16 16 16 16 16 16 16 16 13
13 16 16 16 16 16 16 16 16 16 16 16 16 16 16 13
13 16 16 16 16 16 16 16 16 16 16 16 16 16 16 13
13 16 16 16 16 16 16 16 16 16 16 16 16 16 16 13
13 16 16 16 16 16 16 16 16 16 16 16 16 16 16 13
13 16 16 16 16 16 16 16 16 16 16 16 16 16 16 13
13 13 13 13 13 13 13 16 13 13 13 13 13 13 13 13